**********************
*   *   ** **     *   
* *   * E     *** * **
* * *  **  ****   * **
*** ******    *** *  *
*          **  **    *
***** ******   ***** *
*     *   *******  * *
* *******        *   *
*                 * ***
******* ********** ***
******* **************
*   *   ** **     *   
* *   *       *** * **
* * *  **  ****   * **
*** ******    *** *  *
*          **  **    *
***** ******   ***** *
*     *   *******  * *
* *******      S *   *
*                * ***
****************** ***